- X - - - - - - - - - X - X - 
M - X X - X X X X X - - - - M 
- - - X - X - - - - X - - X M 
- X - - - X X X X - - - X - M 
- X X - X - - - X X - - - M X 
- - - - - - X - - X - X - M X 
- X X X - - - - - X M X - - X 
- - - - X - X X - - - - X - - 
- - X - X M X - X - X - - - - 
- - - X - - X - - - - X - X P 
- X - X - - - - X - X X - - - 
- X X - - - - X - - - - - - X 
- P X - X - - - X - X - - X - 
- M - P - - X - - X X M X - - 
- - X - - - - X - - - - - - X 
=====
- - - - - X X - - - - - - - - 
X - X X - P - X - X X X X - X 
- X X - X X - X X - - - M - - 
- - - - M X - - X - X - X - X 
- X X X - - X P - - X - X - M 
- X M - - - - X - X M - - - X 
- - X X X - - - - - - M - X - 
- X - - - - - - - - X X X - - 
- X M X X X X - - - X - - - - 
- X - - - - M - M X X - X - X 
- - - X - - X - - - - - X - - 
- - - - X - X - M X - X - X - 
X - - - - - - X - X - - - - - 
P - - - X - X - - X - X X X - 
- X - - - - - - X - - - - - - 
=====
X X - - X X - - - - - - - - - 
X - X - - - M X - - - X X X X 
M - X - X - X - - X - - M - - 
- X - - X X - M X - - - - X - 
- - X - - - M X - - X - - X - 
- - - X - X - X - X - - X X - 
- X - - - X - - - - - X - - - 
- X X X X - X - X - X - - - - 
- - - - - - - - X - X - X X - 
- X - - - - - - - X - - X - - 
- - X - - - - X - X - X - - X 
- M - X X X X - - - M X - - - 
M X - - P - - - - X X X - - M 
- X X X X X - - - X - - X - X 
- M - - P - - P - - X - - - - 
=====
- X - M - X - - - - - - - - X 
M - - - - X - X - X X - X - - 
P X X - - X - - X M - - X X - 
M X - - - - X - - - X M - X - 
- - - X - - - X - M X X - X - 
- - X - X - - M - - - - X X - 
- X X - - - - - X - - X - - - 
- M - - X X - X - M - - - X - 
X X - - - - X - - - X X P - - 
- X - X X - X - - - X - M X P 
- - - - X - - X - X - - X - - 
- X X - - - - - X X - - - - X 
- X X X - - X - X - - - - - - 
- - X - - X X - X - X - - - X 
X - - X - - - - - - X - X - - 
=====
- X - - - - - - M - - - - - X 
- M X X X X - - - X - - - - X 
X - - - - - X - - - X - X M - 
P X X X X - - X - X M - - X - 
- - - - X X - X - - - X X - - 
- X - X - - - - - X - - X - X 
- - - - - - - X - - - X X - - 
- X - X - - X - - X - - M - X 
- X - - X - X - X - - X X - - 
- X - - X - - X - - X X - - - 
- - - X - - X M - X - X X - - 
- X - M - X - - X M - M - - - 
- X - - - X - X - - X P X - X 
- X X - X X - - X - X - - - P 
- - - - - - - X M - - - - X - 
=====
- X X X - X - - - P - - X X - 
- - - - - - - - X - X M - - - 
X - M - X - X - X - - X - X - 
- X - X - - X - - - X - - X - 
- - - - X - - X - X - - X - - 
X X X - - X - X - X - X - - X 
- - - - - X - - X - - - X - P 
- X - - - - X - - - - - - - M 
- X M - - X - M X - - X - X M 
- X - - - M - - - X - X - X - 
- - X X X - X X M - - - - X - 
- X M - - X - - - - X - X - - 
- - - X - X - X - - - - X - - 
- X X - - X - X X - X X X P X 
- - - X - - - - X M - - - - - 
=====
X X - X - - - - X - - - - - X 
P - - - X - X - - - X - X - - 
- X X - X - - X - - - X X - X 
- - X M - - - X - X - - - - - 
X - M X - X - - - - - - - - X 
- X M X - X - - X - - X - - - 
- - - X - - - - M X - - X X M 
X - X - - X - - - - X - - X - 
- - X - M P - X - - X - X - - 
- X - - X - - - - X - - X X M 
- - - X - - - X X - - X - - - 
X - X - - X X - M - X - X X - 
- - X - M - - X X - X - - - - 
- X X - X X - - - - X M X - X 
- - - - X - - - - X - - - - P 
=====
- - - - - - X - - - - - - X - 
X - X - - - - X - X - X M - - 
- X - - X - X - - X - X - X - 
- - X X - - X - X M - - - X - 
- - - - M X X - X - X - X - - 
- - - X X - - - X - X - - - - 
- X - - X M X X X M - X - - - 
- - - - - - - - - - - X M X X 
- X - X - X - X X - - X - - - 
- - X - - X - - X X X - - X - 
- - - - - M X - - - - - - X - 
- X - X X - - - - X P X X - - 
- X - - - - X X - X X X - - X 
- X - X - X - - - X P P - X - 
- - M - - - M X - M - X - - - 
=====
- - X - - - X - M M - - - - - 
X - - - X - - X - - X - X X - 
- X X X M X - X - X - - - - - 
- - - - - X - - X - - M X X - 
- - X - - - X M X - - - - - - 
- X - - X - X - X - - X - X M 
- - - X P - X - - X - - X - P 
- X X - - X X P X - X - X - X 
- X - - X - - - X M - - X - - 
- - X - - - X - - - X X - X - 
- X - - X - - - X M X - M - - 
- - X M - - X X - - - X - X - 
X - - - - X - - - X - X - - - 
- - - X - - - X X - X - - X - 
- X - - - X X - - - - - X - - 
=====
M - X - - - - - - X X - X - - 
X M - X X - X - - X - - - - X 
- X - - - - X X - - - P X P - 
- X X X - X - - X X X - M - X 
- - - - - - - X - - X - X X - 
- X - - X X - - X - X - X - - 
- X - - - - X - - - X - - M X 
- - - X - - - - X - - X - - - 
X X X - - X - X - - - - X - X 
M - - X - X - X - - - - X - - 
- - M - - X - - X - X - - X - 
- - X M X - X - M - - X - X - 
- - - X - - - X X X X - - X - 
- X - X - - - - - - - - - P - 
- X - - - - X - - - M - - M X 