- - X - X - X M - - X - - - - - X X - - 
X M - - - - - - - X - - - M M - X - - - 
- X - - - - - - - - - - - - - - - - - - 
- - - - X - - - - X - X - - - X - X - X 
- P - - - X - - X - - X X - X - - X - - 
- - - - - - - X - - - - X - - - X X - X 
- - - - - X - X - - X - - X - - - - - - 
- - - - X - - X X - - P - X - X - X - - 
M - X - X - - - X - X - - - - X - X X - 
- - - - - M X - - - - - - - - X - - X - 
- X - M X X X - - X - X X - - - - - X - 
- - - - X - - - - - - X X - X - - X - - 
- - - - X - X - - - - - - X X - - X - - 
- X X - - - - - - - - - - - - - - X - X 
- - X - X X - X - - - - - - X - - - - - 
- - - - - X - - - - X - X X - M X - X - 
- X - X X - - - X X - - - - - - - X - X 
X X - X - - - M - X - - - - - - - - M - 
- X - X P X - - - X - - - - - - - X - - 
- - - - - - X - X - - X - - - - - - - X 
