M - - P -
- X - - X
M - - - -
- - - M -
- X X - -
