X - P - - - X M - -
M - - - - - - - X -
- - X X - - - X X -
- - - M - - - - - M
- X - - X X - X - X
- M X X X - - M - -
- - - - X - - X - X
X X - - - - - X - X
- M - - - M - - - M
- - - - X - - - - -
