X M - - - - X - - M
- - - P - - - - X -
M - X X - - - X X -
- - - - - - M - - -
P X M - X X - X - X
M - X - X - M - - P
- - - - X - - X - X
- - - - - - - X - X
- - - P - - - - - -
M - - - X - - M - M
