- - - P -
- X - - X
M - - - -
P - - M -
- X X - -
