- - - - X - - - X X 
X - X - - - X - - - 
- X - X X X - X X - 
- M - M P X - - X M 
- X - X - - - X - - 
- X - X X - X - - X 
- X - - X - X - X - 
- - X - X - X - X M 
X X X - X X - - - - 
X X X - - - - X X - 